7 7
5
#######
####G##
##G####
######G
#G#####
####G##
###S###
